wwwwwwwwwwww
w        s w
wn         w
w          w
w          w
w          w
wwwwwwwwwwww
