wwwwwwwwwwww
w          w
w        h w
w          w
w  sb      w
w          w
wwwwwwwwwwww
